















