















